11111111111111111111111111111111
1E000000000000E11E000000000000E1
10000000000000011001101111011001
10001110011100011000000000000001
10001E0000E1000110001E0000E10001
10000000000000000000100110010001
10000000H00000000000100110010001
10001E0000E1000110001E0000E10001
10001110011100011000000000000001
10000000000000011001101111011001
1E000000000000E11E000000000000E1
11111110011111111111111001111111
1E000000000000E11E000000000000E1
10011001100110011000001000001001
10000001100000011000001000001001
10011E0110E1100110000E1000E01001
10000001100000000011100011100001
10000001100000000000011100011101
10011E0110E1100110010E0001E00001
10000001100000011001000001000001
10011001100110011001000001000001
1E000000000000E11E000000000000E1
11111111111111111111111111111111
