1111111111111111
1000000000000001
1000000000000001
1011101110111001
1010001010101001
1011101110101001
1000000000000001
1000000000000001
1000000000000001
1000000000000001
1000000000000001
1111111111111111