1111111111111111
1000000E00000001
1000000000000001
1000111001110001
1000100000010001
1000000000000001
10000000H0000001
1000100000010001
1000111001110001
1000000000000001
1000000000000001
1111111111111111
