1111111111111111
1E00000EE00000E1
1001100110011001
1000000110000001
10011E0110E11001
1E000001100000E1
1E0000H1100000E1
10011E0110E11001
1000000110000001
1001100110011001
1E00000EE00000E1
1111111111111111
