1111111111111111
1E000000000000E1
1001100110011001
1000000110000001
10011E0110E11001
1000000110000001
1000H00110000001
10011E0110E11001
1000000110000001
1001100110011001
1E000000000000E1
1111111111111111
