1111111111111111
1E000000000000E1
1000001000001001
1000001000001001
10000E1000E01001
1011100011100001
1000011100011101
10010E0001E00001
100100H001000001
1001000001000001
1E000000000000E1
1111111111111111
