11111111111111111111111111111111
10000000000000011000000000000001
10000000000000011001101111011001
10001110011100011000000000000001
10001000000100011000100000010001
10000000000000000000100110010001
10E00000H00000000000100110010001
10001000000100011000100000010001
10001110011100011000000000000001
10000000B00000011001101111011001
10000000000000011000000000000001
11111110011111111111111001111111
10000000000000011000000000000001
10011001100110011000001000001001
10000001100000011000001000001001
10011001100110011000001000001001
10000001100000000011100011100001
10000001100000000000011100011101
10011001100110011001000001000001
10000001100000011001000001000001
10011001100110011001000001000001
10000000000000011000000000000001
11111111111111111111111111111111
