1111111111111111
1E000000000000E1
1000000000000001
1000111001110001
10001E0000E10001
1000000000000001
10000000H0000001
10001E0000E10001
1000111001110001
1000000000000001
1E000000000000E1
1111111111111111
