1111111111111111
1E000000000000E1
1001101111011001
10000000H0000001
1E001E0000E100E1
1000100110010001
1000100110010001
1E001E0000E100E1
1000000000000001
1001101111011001
1E000000000000E1
1111111111111111
