1111111111111111
1E000000000000E1
1E000000000000E1
1E000000000000E1
1E000000000000E1
1E000000H00000E1
1E000000000000E1
1E000000000000E1
1E000000000000E1
1E000000000000E1
1E000000000000E1
1111111111111111
