1111111111111111
1000000000000001
1000000B00000001
1000000000000001
1EEEEEEEEEEEEEE1
1EEEEEEEEEEEEEE1
1000000000000001
1000000000000001
1000000000000001
1000000H00000001
1000000000000001
1111111111111111
